###########################################################################################################################################
############################.......########################################################################################################
############################.......########################################################################################################
########...........................#.....................................................................................##################
########.....###............########......................................................................................#################
########.....###.....@......#...........................................#######################............................################
########.....###............#################..................................#..............##............................###############
#...........................................##.......##...................####..#..............############################################
#.#########################################..##.....##...................#....#..#............................................#############
#.#...........................................##...##...................#.....#...#.......................###################..############
#.#.############################################..##....................#.#...#..#.......................##.................##..###########
#.#.##########################################...##.....................#..##...#.......................##...................##..##########
#.#.............................................##.....................###.....#.......................##........######.......##..#########
#.###############################################.....................##..######......................##........##.....##......##..########
#..........#.........................................................##..............................##........##.......##......##..#######
##########.##.....################################..................##..............................##........##.................##..######
###########.##....#...............#..............#........###########..........................##..##..........#####..............##..#####
############.##...#..............#...............#........###########.........................##..##...............#...............##..####
#############.##..#.............#................#........###########........................##..##.................................##..###
##############.##.#............#.................#........###########.......................##..####.#.##.#.##.#.##.#.##.#.##.#.##.#.##..##
##############.#..#...........#..................#........###########......................##..##..#.##.#.##.#.##.#.##.#.##.#.##.#..##..###
##############.#..#######.########################........#.........##....................##..#....................................##..####
##############.#..#...............#..............#.......##..........##..................##..#######################################..#####
##############.#..#..............................#.....#..............##................##...........................................######
##############.#..#...............#..............#....##...............##..............####################################################
##############.#..#######..#######################..##..................##............#####################################################
##############.#..#................................##....................##..........######################################################
##############.#..#...............................##......................##........#######################################################
##############.#..########################################################.##......########################################################
##############.#.........#.......#..........#........#.......#...#....#.....##....#########################################################
##############...............................................................##..##########################################################
###########################################################################################################################################
