###########################################################################################################################################
#<..............###################...............############################################........##############.........#...........##
#..#............#..................................#########################################.......###################......#...........#.#
#..#............#...................................#######################################................................#...........#..#
#..#............#############......................................#########################..............................#...........#...#
#..#............###########...........................#####################################..............................#...........##...#
#..#............#.......................................................................................................#............##...#
#..#............#......................................................................................................#............###...#
#..#............#.........................######......................................................................#.............###...#
#..#.############........................#...........................................................................#.............####...#
#........................................#..........................................................................#..............####...#
#........................................#..........................#.................#..............#.............#..............#####...#
#........................................#..........................#.................#...............#...........#.......................#
#...............................#.......#...........................#.....##..........#................#.........#........................#
#................................#######............................#....#............#.................#.......#.........................#
#######..........#################..................................#...#.............#..................#.....#..........................#
###########............###########################..................#..#.............###..................#...#...........................#
##########......#################...................................#.#.............#####..................#.#............................#
##########..........................................................##..............#####...................#.............................#
#..................................................................####..............###..................................................#
#...................................................................####...............#........................................###########
#..............................................................########.................#....................................##############
#..........................................############################..................#..................######################........#
#...###...................................#...............................................#...............................................#
#......#.................................#.................................................#..............................................#
#.......#...............................#...................................................#.............................................#
#........#.............................#.....................................................#...........##################################
#........#....................................................................................#........####################################
#........#.......############........##############################################............############################################
#.....###.......#############.......######################################.....................................................############
#####..........##############......######################################.......................................................###########
###########################################################################################################################################