###########################################################################################################################################
#.................#......#.#................#............@.............................#..........................#.......................#
#...........#.....#........#####............#.................................#######..#..........................#...@..##############...#
#...........#.....#......#..................###################################.....#...#.......@........#######..#.......................#
#...........#.....#......#.#................#........................................#...#..............#......#..#####################...#
#...........#.....########.##################.........................................#...#............#.......#..........................#
#...........#...............................#..........................................#...#..........#........########...................#
#....@......################################################............................#...#........#...........#........................#
#..........#...................................#...........#####################.........#...#.......#####.......#........................#
#.........#....................................#.#######...#............#......#..........#...#..................#........................#
#........#.............................######..#..#..........#...#......#......#############...###################........................#
#.......#...................................#..##.#.########..###.....#....#..............................................................#
#...........................................#..#..#........#..........#....#..............................................................#
#.......####################................#..#.###.##.##########################################################........................#
##.........................#................#...@....#.....#................................................##............................#
#.#........................#....@...........######..########................................................##............................#
#..#..........@............#...................#.........#..........####################....................##............................#
#...#......................#...................#.........#.........#..............#............>.........#########............@...........#
#....#..............@......#..........@........#.........#........#...............#......................#########........................#
#.#...#....................#...................#....@....#........#...............#......................#########........................#
#..#...#...................#...................#.........#........#...............#......................#########........................#
#...#...#..................#...................#.........#.......#................#......................#########........................#
#....#.....................#...................#................#.................#...........@..........#########........................#
####....################################.#####.##################........................................#########........................#
#......#.....................................#..................##.......................................#########........................#
#.#####..........#.....#..#######............#..................##.......................................#########........................#
#....#...........#.....#.....#...............#..................##.......................................#########........................#
###.#............#######.....#...............#..................##.......................................#########........................#
#...#............#.....#.....#...............#..................##.......................................#########........................#
#................#.....#..#######............#.......<..........##.......................................#########........................#
#............................................#..................#####################.....................................................#
###########################################################################################################################################