###########################################################################################################################################
#.........................#...............................................................................................................#
#.........................................................................................................................................#
#.........................#...............................................................................................................#
############################################.########################################..####################################################
#........<...................................#............................................................................................#
#............................................#............................................................................................#
#####################################################################################################################..####################
#.........................#.......................#........#.........................#..............................#.....................#
#.................................................#........#.........................#..............................####################..#
#.........................#.......................#........#.........................#..............................#.....................#
###########################..#################################################....######.##############################..###################
###########################..################################################..#########.############################....##################
#............................#.....................................................#......................#...............................#
#............................#..........................................>..........#......................#...............................#
#............................#.....................................................#......................#...............................#
###############################.####################################################.####################.#####################..##########
#.......................#........#...........................#..........................#.................................................#
#.......................#........#..................#........#.........############......#................................................#
#.......................##########..................#........#.#########..........#.......######..........................................#
#...................................................#.............................#........#####..........................................#
#####################..############################################################.#######################################################
#......................#............................................................#.....................................................#
#............###########..#........................................................#......................................................#
#............#.....##.....#.............###########################################.......................................................#
#..............##......###................................................................................................................#
###################.################################################################################.######################################
#....................#....................................#.....................#..................................................#......#
#....................#....................................#.....................#........................................#.........#......#
#.##############################.###################.###########.##############.############.#############################.###########.####
#.###############........................#............................#............................#......................................#
#........................................#............................#............................#......................................#
###########################################################################################################################################