###########################################################################################################################################
#.......#.......#.........................................................................................................................#
#.......#........................................................###......................................................................#
#..######........................................................###########################################.....##########################
#.......#.......#.........................##########################......................................................................#
#.......#.......#................................................###......................................................................#
#.......#.......#................................................##########################.....###########################################
#.......#.......#................................................###......................................................................#
#.......#.......#................................................###......................................................................#
#.......#.......#...............................############################################################################.........######
#.......#.......#..............................#####################......................................................................#
#...............#..............................#####################......................................................................#
#...#####################################################################################################################################.#
#...............................................................>###<.........................#...........................................#
##############################################################################.########################################################...#
#.......#####################################################....#############.####.......................................................#
#.......###################################################......#######.......####.......................................................#
#.......##################################################.......######..#####.####.......................................................#
#.......#################################################........###.....#.....#..........................................................#
#.......#........................................................###.....#.....#########################################################..#
#.......#....................................#########...........###.....#.....#..........................................................#
#.......#..................######.......##############...........###.....#.....#..........................................................#
#.......#.................######.................................###.....#.....##.#########################################################
#.......#..................######................................###.....#.....#..........................................................#
#.......#.......########.........................................###.....#.....#..........................................................#
#.......#........########........................................###.....#.....##########################################################.#
#.......#..#######...............................................###.....######...........................................................#
#.......#.........#######........................................###......................................................................#
#.......#................####################....................###...........############################################################
#............................................#############....######..........#...........................................................#
#############################################.............................................................................................#
###########################################################################################################################################