###########################################################################################################################################
#.................................................#.......................................................................................#
#..##########################################################################################.##########################################..#
#..................................#...................................................................................................#..#
#..#..#..###########################...................................................................................................#..#
#..#..#................................................................................................................................#..#
#..#..#................................................................................................................................#..#
#..#..#................................................................................................................................#..#
#..#..#................................................................................................................................#..#
#..#..#.................................#############################################..................................................#..#
#..#..#.................................#...........................................#..................................................#..#
#..#..#.................................#..#######################################..#..................................................#..#
#..#..#.................................#..#......#..............................#..#..................................................#..#
#..#..#.................................#..#..##..#..##########################..#..#..................................................#..#
#..#..#.................................#..#..##..#..#...........................#..#..................................................#..#
#..###################..................#..#..##..#..#..##########################..#..................................................#..#
#..#....................................#..#..##.....#..............................#..................................................####
#..#..###################################..#..##################################################################..........................#
#..#..#.................................#..#...................................................................#..........................#
#..#..#..##..############################..##################################################################..#..........................#
#..#..#..#..............................#..#...................................................................#..........................#
#..#..#..#..################..###########..#..##################################################################..........................#
#..#..#..#..#...........................#..#...................................................................#..........................#
#..#..#..#..#..##########################..##################################################################..#..........................#
#..#..#.....#..............................#................................................................#.............................#
#..#..#..#..#..#..########################################################################################..#..#..........................#
#..#..#..#..#..#..#.........................................................................................#..#..........................#
#.....#..#..#..#..#..########################################################################################..#..........................#
#..#..#..#..#..#..#............................................................................................#..........................#
#..#..#..#..#..#..##############################################################################################..........................#
#..#..#..#..#..#........................<.#...............................................................................................#
###########################################################################################################################################